1111111111111111111111111111111111
1E000000000000000000C0000000000001
1010010100100000000000010000100001
1010010010101010001001000000010101
1P000000000000000000C0000000000001
1111111111111111111111111111111111