1111111111111111111111111111111111
100E000000000000000000000000000001
1111111111111110001111111111111111
10000C0000000000000011100000000001
1P0000010000000000001C100000000001
1111111111111111111111111111111111