1111111111111111111111111111111111
1E000000000000000000000000C0000001
1000000000000000000000000000000001
1111111111111111111101111111111111
1P00000000000000000000000000000001
1111111111111111111111111111111111