111111111111111111111111111
1C0000000000000000000000001
111110000011111000000000111
100000000001110000000000001
10E000000001110000001C10001
100000000000000000001110001
100000000000000000000000001
100000000000000000000000001
10000P000000000000111100001
100000000000000000111100001
111111111111111111111111111