    111111111111111         
   10000000000000011        
  1111111111110000011       
 1CCCCCCCCCCCC1100001111111 
1CCCCCCCCCCCCCC100001000E001
1CCCCCCCCCCCCCC0000010000001
1CCCCCCCCCCCCCC1000010000001
 111111111111110000010000001
  10000000000000000010000001
  10000000000000000010000001
  10000000000000000010000001
  10000000000000000010000001
  10000000000000000000000001
  1000000111000000001000001 
  10000001 100000000111111  
  10000001 1000000001       
  10000001 1000000001       
  100P0001 1000000001       
  1101111   11111111        