111111111111111111111111111111111111111111111111111111111111
1000000000000000000000000000000011100000000000000000000000E1
100000000100000000011100000000000000000000011000000000000001
10000P00010000C000011100000C0000100000000001100000000C000001
100000000100000000000000000000001110000000000000000000000001
111111111111111111111111111111111111111111111111111111111111