1111111111111111111111111111
1111000000000000001111111111
1111111111111100000111111111
11CCCCCCCCCCCC11000011111111
1CCCCCCCCCCCCCC100001000E001
1CCCCCCCCCCCCCC0000010000001
1CCCCCCCCCCCCCC1000010000001
1111111111111110000010000001
1110000000000000000010000001
1110000000000000000010000001
1110000000000000000010000001
1110000000000000000010000001
1110000000000000000000000001
1110000001110000000010000011
1110000001110000000011111111
1110000001110000000011111111
1110000001110000000011111111
11100P0001110000000011111111
1111111111111111111111111111